111111111111111111111111111111111111111111111111
100000000000000000010005000010000000000000000001
100000000000000000010001100010000000000000000001
100000000000000000010300003010000000000000000001
100000000000000000010300003010000000000000000001
100000000000000000010300003010000000000000000001
100000000000000003000003000000300000000000000001
100000000000000000011111111110000000000000000001
100000000000000030000000000000030000000000000001
100000000000000111000000000000111000000000000001
100000000000000000000000000000000000000000000001
111111111111111111100000000001111111111111111111
100000000000000000000003000000000000000000000001
100000000000000000001111111100000000000000000001
100000000000000000000000000000000000000000000001
100000000000000001100000000001100000000000000001
100000000000000000000003000000000000000000000001
100000000000000000001111111100000000000000000001
100000000000001111000000000000111100000000000001
100000000030000000000000000000000000300000000001
100000000111100000000000000000000001111000000001
100000000000000000000000000000000000000000000001
111111110000000000000000000000000000000011111111
100000000000000000000000000000000000000000000001
100000000000000000000000000000000000000000000001
111111111111111111111030111111111111111111111111
100000000000000000000000000000000000000000000001
100000000300000000000000000000000003000000000001
100000100000001100000111000000011000000010000001
100000000000000000000000000000000000000000000001
100010000000000000000000000000000000000000010001
100000000000000000000000000000000000000000000001
100000000000000000000000000000000000000000000001
111111111111030111111111111111103011111111111111
100000000000000000000000000000000000000000000001
100000000001111000000000000000001111000000000001
100000000000000000000000000000000000000000000001
100300111100000000000000000000000000011110003001
100000000000000111111111111111100000000000000001
111110000300000000000000000000000000000000011111
100000000000000000000000000000000000000000000001
100000003000000000000000000000000000000300000001
111111111111111111111111111111111111111111111111