CCCCCCCCCCCCCCCCCCCCCCCCCCCCCCCCCCCCCCCCCCCCCCCC
C------------------C---W----C------------------C
C------------------C---CC---C------------------C
C------------------C-E----E-C------------------C
C------------------C-E----E-C------------------C
C------------------C-E----E-C------------------C
C----------------E-----E------E----------------C
C------------------CCCCCCCCCC------------------C
C---------------E--------------E---------------C
C--------------CCC------------CCC--------------C
C----------------------------------------------C
CCCCCCCCCCCCCCCCCCC----------CCCCCCCCCCCCCCCCCCC
C----------------------E-----------------------C
C-------------------CCCCCCCC-------------------C
C----------------------------------------------C
C----------------CC----------CC----------------C
C----------------------E-----------------------C
C-------------------CCCCCCCC-------------------C
C-------------CCCC------------CCCC-------------C
C---------E-------------------------E----------C
C--------CCCC----------------------CCCC--------C
C----------------------------------------------C
CCCCCCCC--------------------------------CCCCCCCC
C----------------------------------------------C
C----------------------------------------------C
CCCCCCCCCCCCCCCCCCCCC-E-CCCCCCCCCCCCCCCCCCCCCCCC
C----------------------------------------------C
C--------E-------------------------E-----------C
C-----C-------CC-----CCC-------CC-------C------C
C----------------------------------------------C
C---C--------------------------------------C---C
C----------------------------------------------C
C----------------------------------------------C
CCCCCCCCCCCC-E-CCCCCCCCCCCCCCCC-E-CCCCCCCCCCCCCC
C----------------------------------------------C
C----------CCCC-----------------CCCC-----------C
C----------------------------------------------C
C--E--CCCC---------------------------CCCC---E--C
C--------------CCCCCCCCCCCCCCCC----------------C
CCCCC----E----------------------------E----CCCCC
C----------------------------------------------C
C-------E------------------------------E-------C
CCCCCCCCCCCCCCCCCCCCCCCCCCCCCCCCCCCCCCCCCCCCCCCC